#
#
#	akutils primer sequences list
#
#	add or remove sequences with akutils primer_file command
#
#	Usually will want reverse/complement sequence (rc suffix)
#
#	press q to exit this screen
#
#
#PrimerName	PrimerSequence (IUPAC degeneracies OK)
1391F	GTACACACCGCCCGTC
1391Frc	GACGGGCGGTGTGTAC
926R	CCGYCAATTYMTTTRAGTTT
926Rrc	AAACTYAAAKRAATTGRCGG
806R	GGACTACHVGGGTWTCTAAT
806Rrc	ATTAGAWACCCBDGTAGTCC
515F	GTGCCAGCMGCCGCGGTAA
515Frc	TTACCGCGGCKGCTGGCAC
515Fmod	GTGYCAGCMGCCGCGGTAA
515Fmodrc	TTACCGCGGCKGCTGRCAC
5.8S_Fun	AACTTTYRRCAAYGGATCWCT
5.8S_Funrc	AGWGATCCRTTGYYRAAAGTT
AML2	GAACCCAAACACTTTGGTTTCC
AML2rc	GGAAACCAAAGTGTTTGGGTTC
EukBR	TGATCCTTCTGCAGGTTCACCTAC
EukBRrc	GTAGGTGAACCTGCAGAAGGATCA
ITS1F	CTTGGTCATTTAGAGGAAGTAA
ITS1Frc	TTACTTCCTCTAAATGACCAAG
ITS2	GCTGCGTTCTTCATCGATGC
ITS2rc	GCATCGATGAAGAACGCAGC
ITS3	GCATCGATGAAGAACGCAGC
ITS3rc	GCTGCGTTCTTCATCGATGC
ITS4_Fun	AGCCTCCGCTTATTGATATGCTTAART
ITS4_Funrc	AYTTAAGCATATCAATAAGCGGAGGCT
ITS4	TCCTCCGCTTATTGATATGC
ITS4rc	GCATATCAATAAGCGGAGGA
ITS5	GGAAGTAAAAGTCGTAACAAGG
ITS5rc	CCTTGTTACGACTTTTACTTCC
ITS7o	GTGAATCATCRAATYTTTG
ITS7orc	CAAARATTYGATGATTCAC
LR0R	ACCCGCTGAACTTAAGC
LR0Rrc	GCTTAAGTTCAGCGGGT
LR3	CCGTGTTTCAAGACGGG
LR3rc	CCCGTCTTGAAACACGG
P5	AATGATACGGCGACCACCGAGA
P5rc	TCTCGGTGGTCGCCGTATCATT
P7	CAAGCAGAAGACGGCATACGAGAT
P7rc	ATCTCGTATGCCGTCTTCTGCTTG
WANDA	CAGCCGCGGTAATTCCAGCT
WANDArc	AGCTGGAATTACCGCGGCTG
